# classes
OledDisplay	KEYWORD1
OledDisplayParallel	KEYWORD1
OledDisplaySpi	KEYWORD1
# methods
CommandDisplay	KEYWORD2
DataDisplay	KEYWORD2
SetContrastReg	KEYWORD2
SetColAddr	KEYWORD2
SetPageAddr	KEYWORD2
ActivateHorScroll	KEYWORD2
DeactivateHorScroll	KEYWORD2
SetEntireDisplay	KEYWORD2
TurnOnDisplay	KEYWORD2
SetMultiplexRatio	KEYWORD2
ClearAfterCol	KEYWORD2
SetPixel	KEYWORD2
ClearDisplay	KEYWORD2
SetPageValue	KEYWORD2
DrawImage	KEYWORD2
DrawImageInverted	KEYWORD2
Init	KEYWORD2
